*****************.*************
*   $          **             *
* *** ******** ** ***** ***** *
* *-* ******** ** ***** ***** *
* *-*    **    **    **    ** *
* *** ** ** ** ** ** ** ** ** *
*     **    **    **    **    *
* ****** *****.******** ***** *
* ****** *****.******** ***** *
*        .........**          *
***** *****.*****.** ** ** ****
***** *****.*???*.** ** ** ****
*        **.*???*... ** **    *
* ****** **.+???*.*****.***** *
* ****** **.+???*.*****.***** *
*        **.*???*... ** **    *
***** *****.*???*.** ** ** ****
***** *****.*****.** ** ** ****
*        .........**          *
* ****** *****.******** ***** *
* ****** *****.******** ***** *
*     **    **    **    **    *
* *** ** ** ** ** ** ** ** ** *
* *-*    **    **    **    ** *
* *-* ******** ** ***** ***** *
* *** ******** ** ***** ***** *
*   $          **             *
*****************.*************
